######...###########
 ##s.t............##
 t........#####..ttt
 tt...##..tt  #....t
##....##..#####....t
t..g...tww..cwww....
t.....w.w..wtww.....
t#................tt
 tttt.....tttt.....t
  tttt.@..ttt.....tt
   tt.......tt.q..##
    ttt.b........www
      ############  
