#############       
#...........########
#...................
#.q.........#####..#
#...........#   #..#
#...........#   #..#
#...........#   #..#
#...........#   #b.#
####....#####   ####
    #..#            
    #..#            
    #..#            
   #....#           
