#############
#...........#########
#...................
#.q.........#####..##
#...........#   #..#
#...........#   #..#
#...........#   #..#
#...........#   #b.#
####....#####   ####
    #..#
    #..#
    #..#
   #....#
