#############
#...........#########
#.........s..........
#.q..................
#...........#####..##
#...........#   #..#
#......g....#   #..#
#...........#   #b.#
####....#####   ####
    #..#
    #..#
    #..#
    #..#
