######...############
 ##s.t.........g....#
 #........#####.....#
 #t.......ttwt#.....#
##....##..#####.....#
#.....tww.##.........
#b....w.ws.#.........
##.................##
 ####.....#..t......#
##...ttt......ttt####
 #..s.........##.q..#
 ###tt..........### 
   ##############   
