   ##########       
   #........#########
####.................
#.q#....#########..##
#.t#....#...#   #..#
#.t#..@.#...#   #..#
#.......#...#   #..#
#...........#   #b.#
####....#####   ####
    #..#
    #..#
    #..#
    #..#
