#############
#...........#
#...........########
#.q.................
#...........#####..#
#.....@.....#   #..#
#...........#   #..#
#...........#   #b.#
####....#####   ####
    #..#           
    #..#           
    #..#
   #....# 
