#############       
#........s..#       
#...........########
#.q...........s.....
#...........#####..#
#...........#   #..#
#...........#   #..#
#...........#   #b.#
####....#####   ####
    #..#            
    #..#            
    #..#            
   #....#           
