 ####################
##..#sc#tw#gm#####.q#
....#..#tw#..##bw#sg#
##..#..#tw#..##.g#..#
##..##.#tw##.###.##.#
 #..................#
 #..wwwwwwwwwwwwwwwww
 #..ttttttttttttttttt
 #..................t
 ###ttttttttt.ttttttt
 wbwwwwwwwwww.wwwwwww
 ..............g...mw
 ####---#############
