#############       
#...........#########
#....................
#.q.........#####..##
#...........#   #..#
#.....@.....#   #..#
#...........#   #..#
#...........#   #b.#
####....#####   ####
    #..#
    #..#
    #..#
   #....#
