 ###################
##......##....s....#
.....g..####.......#
##......##.........#
 ###.........####..#
 #....twt....#  #..#
 #.....gb...##  #bq#
 ###....######  ####
    #..#           
 ####..###           
 #c.s....#
 #####...#
     #...#
