 ###################
##..s....##s......##
.......####...b....#
##......##...twwt..#
 ###....tt.........#
 #.................#
 #.....gb...#####.q#
 ###....######  ####
    #..#            
 ####..##########   
 #b.g...........#   
 #####...###....#   
     #...# ######   
