#############       
#...........#########
#....................
#.q..................
#...........#####..##
#.....@.....#   #..#
#...........#   #..#
#...........#   #b.#
####....#####   ####
    #..#
    #..#
    #..#
    #..#
