 ####################
##......##....s.....#
.....g..####........#
##......##..........#
 ###.........####...d
 #....twt....#  #...#
 #.....gb...##  #bq.#
 ###....######  #####
    #..#
 ####..###
 #c.s....#
 #####...#
     #...#
